NO ./textures/north.xpm
SO ./textures/south.xpm
WE ./textures/west.xpm
EA ./textures/east.xpm

F 220,100,0
C 30,30,200

111111
100101
101001
100001
111011
