NO ./textures/north.xpm
SO ./textures/south.xpm
WE ./textures/west.xpm
EA ./textures/east.xpm

F 220,100,0
C 30,30,200

111111111111
100110 000001
1011N1111111
110011
111111
